#Difficulté
Facile
#Taille
7
#Plateau
3 b b n n n b
n n n n 1 n 3
b 3 n b n n b
b n n b 3 n n
n 1 n n n b n
n n n b n 2 n
b 2 n b 3 n n
